###S###
#...#.#
###.#.#
G.#.#.#
#.###.#
#..#..#
#######
