###.###
#.. # #
### # #
G #   #
# ### #
#     #
#######
