###.###
#...#.#
###.#.#
S.#...#
#.###.#
#.....#
#######
